tick,quiet,active,jailed,totalPeople,totalAgent,totalCop,totalJailCount
1,952,522,46,1538,1474,64,46
2,862,552,106,1478,1414,64,106
3,862,495,163,1421,1357,64,163
4,865,437,218,1366,1302,64,218
5,874,382,264,1320,1256,64,264
6,878,334,308,1276,1212,64,308
7,887,293,340,1244,1180,64,340
8,887,265,368,1216,1152,64,368
9,890,232,398,1186,1122,64,398
10,895,203,422,1162,1098,64,422
11,899,174,447,1137,1073,64,447
12,901,153,466,1118,1054,64,466
13,902,133,485,1099,1035,64,485
14,901,112,507,1077,1013,64,507
15,905,96,519,1065,1001,64,519
16,906,91,523,1061,997,64,523
17,929,89,502,1082,1018,64,502
18,925,100,495,1089,1025,64,495
19,916,96,508,1076,1012,64,508
20,922,79,519,1065,1001,64,519
21,931,76,513,1071,1007,64,513
22,921,88,511,1073,1009,64,511
23,922,76,522,1062,998,64,522
24,924,75,521,1063,999,64,521
25,935,72,513,1071,1007,64,513
26,933,70,517,1067,1003,64,517
27,924,81,515,1069,1005,64,515
28,915,88,517,1067,1003,64,517
29,920,80,520,1064,1000,64,520
30,928,80,512,1072,1008,64,512
31,940,83,497,1087,1023,64,497
32,923,93,504,1080,1016,64,504
33,924,81,515,1069,1005,64,515
34,925,77,518,1066,1002,64,518
35,919,77,524,1060,996,64,524
36,943,67,510,1074,1010,64,510
37,909,94,517,1067,1003,64,517
38,919,80,521,1063,999,64,521
39,918,82,520,1064,1000,64,520
40,935,78,507,1077,1013,64,507
41,937,88,495,1089,1025,64,495
42,929,92,499,1085,1021,64,499
43,936,78,506,1078,1014,64,506
44,915,85,520,1064,1000,64,520
45,917,77,526,1058,994,64,526
46,925,66,529,1055,991,64,529
47,923,58,539,1045,981,64,539
48,931,64,525,1059,995,64,525
49,933,63,524,1060,996,64,524
50,941,60,519,1065,1001,64,519
51,942,78,500,1084,1020,64,500
52,931,97,492,1092,1028,64,492
53,923,105,492,1092,1028,64,492
54,922,94,504,1080,1016,64,504
55,923,89,508,1076,1012,64,508
56,933,80,507,1077,1013,64,507
57,932,89,499,1085,1021,64,499
58,914,95,511,1073,1009,64,511
59,923,80,517,1067,1003,64,517
60,930,80,510,1074,1010,64,510
61,937,82,501,1083,1019,64,501
62,918,90,512,1072,1008,64,512
63,925,76,519,1065,1001,64,519
64,921,73,526,1058,994,64,526
65,921,62,537,1047,983,64,537
66,921,61,538,1046,982,64,538
67,933,64,523,1061,997,64,523
68,929,69,522,1062,998,64,522
69,925,86,509,1075,1011,64,509
70,941,96,483,1101,1037,64,483
71,927,116,477,1107,1043,64,477
72,923,116,481,1103,1039,64,481
73,932,112,476,1108,1044,64,476
74,929,110,481,1103,1039,64,481
75,925,111,484,1100,1036,64,484
76,931,104,485,1099,1035,64,485
77,934,98,488,1096,1032,64,488
78,936,92,492,1092,1028,64,492
79,946,89,485,1099,1035,64,485
80,933,99,488,1096,1032,64,488
81,924,112,484,1100,1036,64,484
82,929,107,484,1100,1036,64,484
83,915,107,498,1086,1022,64,498
84,919,96,505,1079,1015,64,505
85,923,95,502,1082,1018,64,502
86,944,94,482,1102,1038,64,482
87,924,107,489,1095,1031,64,489
88,921,99,500,1084,1020,64,500
89,912,93,515,1069,1005,64,515
90,898,86,536,1048,984,64,536
91,923,63,534,1050,986,64,534
92,932,58,530,1054,990,64,530
93,929,58,533,1051,987,64,533
94,928,62,530,1054,990,64,530
95,925,71,524,1060,996,64,524
96,926,75,519,1065,1001,64,519
97,935,70,515,1069,1005,64,515
98,918,66,536,1048,984,64,536
99,916,56,548,1036,972,64,548
100,936,66,518,1066,1002,64,518
101,935,75,510,1074,1010,64,510
102,939,86,495,1089,1025,64,495
103,935,94,491,1093,1029,64,491
104,955,83,482,1102,1038,64,482
105,936,104,480,1104,1040,64,480
106,924,103,493,1091,1027,64,493
107,919,98,503,1081,1017,64,503
108,926,95,499,1085,1021,64,499
109,927,92,501,1083,1019,64,501
110,937,92,491,1093,1029,64,491
111,940,93,487,1097,1033,64,487
112,921,95,504,1080,1016,64,504
113,924,84,512,1072,1008,64,512
114,930,90,500,1084,1020,64,500
115,931,95,494,1090,1026,64,494
116,941,94,485,1099,1035,64,485
117,928,105,487,1097,1033,64,487
118,923,104,493,1091,1027,64,493
119,913,111,496,1088,1024,64,496
120,900,109,511,1073,1009,64,511
121,921,86,513,1071,1007,64,513
122,933,83,504,1080,1016,64,504
123,925,85,510,1074,1010,64,510
124,936,73,511,1073,1009,64,511
125,926,69,525,1059,995,64,525
126,920,74,526,1058,994,64,526
127,913,74,533,1051,987,64,533
128,915,67,538,1046,982,64,538
129,924,62,534,1050,986,64,534
130,933,57,530,1054,990,64,530
131,926,64,530,1054,990,64,530
132,933,62,525,1059,995,64,525
133,936,71,513,1071,1007,64,513
134,937,77,506,1078,1014,64,506
135,930,84,506,1078,1014,64,506
136,942,86,492,1092,1028,64,492
137,961,92,467,1117,1053,64,467
138,943,116,461,1123,1059,64,461
139,915,124,481,1103,1039,64,481
140,905,126,489,1095,1031,64,489
141,913,110,497,1087,1023,64,497
142,931,95,494,1090,1026,64,494
143,914,100,506,1078,1014,64,506
144,928,88,504,1080,1016,64,504
145,933,88,499,1085,1021,64,499
146,929,87,504,1080,1016,64,504
147,930,84,506,1078,1014,64,506
148,936,93,491,1093,1029,64,491
149,927,99,494,1090,1026,64,494
150,938,95,487,1097,1033,64,487
151,925,103,492,1092,1028,64,492
152,932,107,481,1103,1039,64,481
153,924,104,492,1092,1028,64,492
154,917,92,511,1073,1009,64,511
155,913,92,515,1069,1005,64,515
156,922,82,516,1068,1004,64,516
157,921,78,521,1063,999,64,521
158,928,71,521,1063,999,64,521
159,934,67,519,1065,1001,64,519
160,935,64,521,1063,999,64,521
161,940,59,521,1063,999,64,521
162,938,69,513,1071,1007,64,513
163,935,79,506,1078,1014,64,506
164,936,79,505,1079,1015,64,505
165,944,76,500,1084,1020,64,500
166,945,72,503,1081,1017,64,503
167,919,78,523,1061,997,64,523
168,938,60,522,1062,998,64,522
169,925,70,525,1059,995,64,525
170,935,62,523,1061,997,64,523
171,942,57,521,1063,999,64,521
172,940,65,515,1069,1005,64,515
173,950,67,503,1081,1017,64,503
174,938,74,508,1076,1012,64,508
175,938,83,499,1085,1021,64,499
176,944,83,493,1091,1027,64,493
177,943,90,487,1097,1033,64,487
178,926,105,489,1095,1031,64,489
179,920,100,500,1084,1020,64,500
180,921,101,498,1086,1022,64,498
181,926,94,500,1084,1020,64,500
182,923,97,500,1084,1020,64,500
183,926,80,514,1070,1006,64,514
184,929,84,507,1077,1013,64,507
185,950,85,485,1099,1035,64,485
186,932,99,489,1095,1031,64,489
187,938,92,490,1094,1030,64,490
188,929,96,495,1089,1025,64,495
189,920,96,504,1080,1016,64,504
190,923,92,505,1079,1015,64,505
191,942,90,488,1096,1032,64,488
192,954,98,468,1116,1052,64,468
193,950,98,472,1112,1048,64,472
194,931,102,487,1097,1033,64,487
195,928,96,496,1088,1024,64,496
196,936,80,504,1080,1016,64,504
197,936,83,501,1083,1019,64,501
198,926,87,507,1077,1013,64,507
199,930,84,506,1078,1014,64,506
200,912,88,520,1064,1000,64,520
201,923,73,524,1060,996,64,524
202,920,76,524,1060,996,64,524
203,925,82,513,1071,1007,64,513
204,909,86,525,1059,995,64,525
205,917,79,524,1060,996,64,524
206,929,77,514,1070,1006,64,514
207,931,80,509,1075,1011,64,509
208,927,79,514,1070,1006,64,514
209,945,73,502,1082,1018,64,502
210,931,83,506,1078,1014,64,506
211,941,75,504,1080,1016,64,504
212,937,78,505,1079,1015,64,505
213,932,85,503,1081,1017,64,503
214,923,90,507,1077,1013,64,507
215,922,102,496,1088,1024,64,496
216,937,94,489,1095,1031,64,489
217,932,94,494,1090,1026,64,494
218,926,96,498,1086,1022,64,498
219,934,81,505,1079,1015,64,505
220,929,88,503,1081,1017,64,503
221,912,83,525,1059,995,64,525
222,924,74,522,1062,998,64,522
223,929,77,514,1070,1006,64,514
224,911,77,532,1052,988,64,532
225,919,65,536,1048,984,64,536
226,926,68,526,1058,994,64,526
227,929,77,514,1070,1006,64,514
228,938,71,511,1073,1009,64,511
229,928,82,510,1074,1010,64,510
230,916,91,513,1071,1007,64,513
231,911,89,520,1064,1000,64,520
232,928,80,512,1072,1008,64,512
233,928,88,504,1080,1016,64,504
234,930,84,506,1078,1014,64,506
235,940,81,499,1085,1021,64,499
236,934,93,493,1091,1027,64,493
237,944,103,473,1111,1047,64,473
238,914,117,489,1095,1031,64,489
239,928,96,496,1088,1024,64,496
240,941,93,486,1098,1034,64,486
241,920,91,509,1075,1011,64,509
242,927,80,513,1071,1007,64,513
243,914,77,529,1055,991,64,529
244,925,64,531,1053,989,64,531
245,932,60,528,1056,992,64,528
246,935,71,514,1070,1006,64,514
247,933,79,508,1076,1012,64,508
248,924,80,516,1068,1004,64,516
249,911,81,528,1056,992,64,528
250,914,67,539,1045,981,64,539
251,922,62,536,1048,984,64,536
252,923,63,534,1050,986,64,534
253,913,76,531,1053,989,64,531
254,916,71,533,1051,987,64,533
255,919,60,541,1043,979,64,541
256,924,64,532,1052,988,64,532
257,942,60,518,1066,1002,64,518
258,927,76,517,1067,1003,64,517
259,931,74,515,1069,1005,64,515
260,925,73,522,1062,998,64,522
261,933,72,515,1069,1005,64,515
262,925,67,528,1056,992,64,528
263,926,63,531,1053,989,64,531
264,945,56,519,1065,1001,64,519
265,943,70,507,1077,1013,64,507
266,946,79,495,1089,1025,64,495
267,938,79,503,1081,1017,64,503
268,924,93,503,1081,1017,64,503
269,927,85,508,1076,1012,64,508
270,921,83,516,1068,1004,64,516
271,938,74,508,1076,1012,64,508
272,934,83,503,1081,1017,64,503
273,931,81,508,1076,1012,64,508
274,932,81,507,1077,1013,64,507
275,930,76,514,1070,1006,64,514
276,932,76,512,1072,1008,64,512
277,924,70,526,1058,994,64,526
278,919,71,530,1054,990,64,530
279,932,68,520,1064,1000,64,520
280,945,79,496,1088,1024,64,496
281,946,90,484,1100,1036,64,484
282,919,107,494,1090,1026,64,494
283,923,94,503,1081,1017,64,503
284,939,95,486,1098,1034,64,486
285,923,106,491,1093,1029,64,491
286,924,99,497,1087,1023,64,497
287,934,90,496,1088,1024,64,496
288,921,97,502,1082,1018,64,502
289,938,89,493,1091,1027,64,493
290,934,91,495,1089,1025,64,495
291,922,95,503,1081,1017,64,503
292,931,90,499,1085,1021,64,499
293,928,89,503,1081,1017,64,503
294,927,90,503,1081,1017,64,503
295,926,83,511,1073,1009,64,511
296,939,74,507,1077,1013,64,507
297,924,85,511,1073,1009,64,511
298,932,82,506,1078,1014,64,506
299,934,95,491,1093,1029,64,491
300,930,96,494,1090,1026,64,494
301,928,98,494,1090,1026,64,494
302,923,104,493,1091,1027,64,493
303,915,100,505,1079,1015,64,505
304,910,94,516,1068,1004,64,516
305,901,79,540,1044,980,64,540
306,920,54,546,1038,974,64,546
307,921,60,539,1045,981,64,539
308,938,49,533,1051,987,64,533
309,929,58,533,1051,987,64,533
310,938,51,531,1053,989,64,531
311,945,60,515,1069,1005,64,515
312,935,65,520,1064,1000,64,520
313,940,68,512,1072,1008,64,512
314,948,67,505,1079,1015,64,505
315,948,60,512,1072,1008,64,512
316,938,84,498,1086,1022,64,498
317,939,78,503,1081,1017,64,503
318,929,87,504,1080,1016,64,504
319,936,83,501,1083,1019,64,501
320,940,81,499,1085,1021,64,499
321,928,88,504,1080,1016,64,504
322,925,89,506,1078,1014,64,506
323,915,94,511,1073,1009,64,511
324,916,78,526,1058,994,64,526
325,939,60,521,1063,999,64,521
326,945,60,515,1069,1005,64,515
327,925,73,522,1062,998,64,522
328,940,64,516,1068,1004,64,516
329,935,80,505,1079,1015,64,505
330,928,86,506,1078,1014,64,506
331,922,82,516,1068,1004,64,516
332,920,74,526,1058,994,64,526
333,942,63,515,1069,1005,64,515
334,933,73,514,1070,1006,64,514
335,934,73,513,1071,1007,64,513
336,923,75,522,1062,998,64,522
337,926,74,520,1064,1000,64,520
338,932,80,508,1076,1012,64,508
339,923,91,506,1078,1014,64,506
340,932,85,503,1081,1017,64,503
341,932,84,504,1080,1016,64,504
342,928,84,508,1076,1012,64,508
343,933,82,505,1079,1015,64,505
344,930,93,497,1087,1023,64,497
345,933,88,499,1085,1021,64,499
346,912,94,514,1070,1006,64,514
347,918,79,523,1061,997,64,523
348,938,61,521,1063,999,64,521
349,922,70,528,1056,992,64,528
350,933,63,524,1060,996,64,524
351,946,72,502,1082,1018,64,502
352,920,88,512,1072,1008,64,512
353,912,82,526,1058,994,64,526
354,914,76,530,1054,990,64,530
355,908,75,537,1047,983,64,537
356,923,71,526,1058,994,64,526
357,933,72,515,1069,1005,64,515
358,928,83,509,1075,1011,64,509
359,928,81,511,1073,1009,64,511
360,928,71,521,1063,999,64,521
361,930,67,523,1061,997,64,523
362,942,69,509,1075,1011,64,509
363,940,66,514,1070,1006,64,514
364,947,70,503,1081,1017,64,503
365,941,78,501,1083,1019,64,501
366,938,82,500,1084,1020,64,500
367,950,78,492,1092,1028,64,492
368,923,104,493,1091,1027,64,493
369,928,101,491,1093,1029,64,491
370,934,99,487,1097,1033,64,487
371,938,89,493,1091,1027,64,493
372,944,90,486,1098,1034,64,486
373,925,101,494,1090,1026,64,494
374,930,103,487,1097,1033,64,487
375,928,101,491,1093,1029,64,491
376,916,95,509,1075,1011,64,509
377,931,81,508,1076,1012,64,508
378,942,64,514,1070,1006,64,514
379,928,75,517,1067,1003,64,517
380,923,75,522,1062,998,64,522
381,919,74,527,1057,993,64,527
382,925,68,527,1057,993,64,527
383,918,67,535,1049,985,64,535
384,939,63,518,1066,1002,64,518
385,940,69,511,1073,1009,64,511
386,932,79,509,1075,1011,64,509
387,926,87,507,1077,1013,64,507
388,920,87,513,1071,1007,64,513
389,924,83,513,1071,1007,64,513
390,923,80,517,1067,1003,64,517
391,922,71,527,1057,993,64,527
392,927,63,530,1054,990,64,530
393,941,54,525,1059,995,64,525
394,932,65,523,1061,997,64,523
395,935,77,508,1076,1012,64,508
396,930,88,502,1082,1018,64,502
397,934,80,506,1078,1014,64,506
398,925,90,505,1079,1015,64,505
399,934,74,512,1072,1008,64,512
400,931,85,504,1080,1016,64,504
401,918,86,516,1068,1004,64,516
402,928,78,514,1070,1006,64,514
403,930,73,517,1067,1003,64,517
404,936,81,503,1081,1017,64,503
405,935,78,507,1077,1013,64,507
406,908,94,518,1066,1002,64,518
407,941,79,500,1084,1020,64,500
408,942,84,494,1090,1026,64,494
409,928,94,498,1086,1022,64,498
410,929,98,493,1091,1027,64,493
411,924,88,508,1076,1012,64,508
412,939,81,500,1084,1020,64,500
413,926,95,499,1085,1021,64,499
414,938,89,493,1091,1027,64,493
415,924,86,510,1074,1010,64,510
416,925,84,511,1073,1009,64,511
417,924,77,519,1065,1001,64,519
418,924,76,520,1064,1000,64,520
419,926,91,503,1081,1017,64,503
420,927,98,495,1089,1025,64,495
421,919,107,494,1090,1026,64,494
422,910,110,500,1084,1020,64,500
423,928,101,491,1093,1029,64,491
424,930,97,493,1091,1027,64,493
425,936,88,496,1088,1024,64,496
426,940,93,487,1097,1033,64,487
427,940,99,481,1103,1039,64,481
428,924,104,492,1092,1028,64,492
429,923,97,500,1084,1020,64,500
430,926,83,511,1073,1009,64,511
431,941,76,503,1081,1017,64,503
432,929,84,507,1077,1013,64,507
433,926,76,518,1066,1002,64,518
434,931,70,519,1065,1001,64,519
435,931,66,523,1061,997,64,523
436,934,68,518,1066,1002,64,518
437,930,71,519,1065,1001,64,519
438,928,81,511,1073,1009,64,511
439,926,78,516,1068,1004,64,516
440,940,85,495,1089,1025,64,495
441,935,94,491,1093,1029,64,491
442,935,92,493,1091,1027,64,493
443,926,94,500,1084,1020,64,500
444,916,90,514,1070,1006,64,514
445,912,82,526,1058,994,64,526
446,931,67,522,1062,998,64,522
447,932,75,513,1071,1007,64,513
448,936,69,515,1069,1005,64,515
449,932,87,501,1083,1019,64,501
450,943,81,496,1088,1024,64,496
451,940,92,488,1096,1032,64,488
452,938,95,487,1097,1033,64,487
453,927,96,497,1087,1023,64,497
454,933,100,487,1097,1033,64,487
455,935,101,484,1100,1036,64,484
456,935,97,488,1096,1032,64,488
457,943,100,477,1107,1043,64,477
458,940,103,477,1107,1043,64,477
459,923,108,489,1095,1031,64,489
460,921,100,499,1085,1021,64,499
461,938,90,492,1092,1028,64,492
462,915,102,503,1081,1017,64,503
463,914,97,509,1075,1011,64,509
464,925,95,500,1084,1020,64,500
465,922,97,501,1083,1019,64,501
466,912,84,524,1060,996,64,524
467,918,77,525,1059,995,64,525
468,926,62,532,1052,988,64,532
469,927,57,536,1048,984,64,536
470,926,63,531,1053,989,64,531
471,933,70,517,1067,1003,64,517
472,925,84,511,1073,1009,64,511
473,915,97,508,1076,1012,64,508
474,925,95,500,1084,1020,64,500
475,924,101,495,1089,1025,64,495
476,937,105,478,1106,1042,64,478
477,926,113,481,1103,1039,64,481
478,920,110,490,1094,1030,64,490
479,926,97,497,1087,1023,64,497
480,924,101,495,1089,1025,64,495
481,933,95,492,1092,1028,64,492
482,920,93,507,1077,1013,64,507
483,923,82,515,1069,1005,64,515
484,910,76,534,1050,986,64,534
485,924,67,529,1055,991,64,529
486,941,56,523,1061,997,64,523
487,944,66,510,1074,1010,64,510
488,943,60,517,1067,1003,64,517
489,932,67,521,1063,999,64,521
490,945,74,501,1083,1019,64,501
491,928,94,498,1086,1022,64,498
492,931,83,506,1078,1014,64,506
493,919,85,516,1068,1004,64,516
494,918,76,526,1058,994,64,526
495,905,79,536,1048,984,64,536
496,920,62,538,1046,982,64,538
497,931,65,524,1060,996,64,524
498,927,70,523,1061,997,64,523
499,923,79,518,1066,1002,64,518
500,929,77,514,1070,1006,64,514
501,930,84,506,1078,1014,64,506
502,932,89,499,1085,1021,64,499
503,939,88,493,1091,1027,64,493
504,929,96,495,1089,1025,64,495
505,923,94,503,1081,1017,64,503
506,921,99,500,1084,1020,64,500
507,937,98,485,1099,1035,64,485
508,935,97,488,1096,1032,64,488
509,942,96,482,1102,1038,64,482
510,947,90,483,1101,1037,64,483
511,930,101,489,1095,1031,64,489
512,940,94,486,1098,1034,64,486
513,931,104,485,1099,1035,64,485
514,921,100,499,1085,1021,64,499
515,929,89,502,1082,1018,64,502
516,933,83,504,1080,1016,64,504
517,940,81,499,1085,1021,64,499
518,938,90,492,1092,1028,64,492
519,932,92,496,1088,1024,64,496
520,924,96,500,1084,1020,64,500
521,931,87,502,1082,1018,64,502
522,935,70,515,1069,1005,64,515
523,944,61,515,1069,1005,64,515
524,931,65,524,1060,996,64,524
525,916,73,531,1053,989,64,531
526,924,65,531,1053,989,64,531
527,920,69,531,1053,989,64,531
528,920,74,526,1058,994,64,526
529,918,70,532,1052,988,64,532
530,939,62,519,1065,1001,64,519
531,959,61,500,1084,1020,64,500
532,948,81,491,1093,1029,64,491
533,945,95,480,1104,1040,64,480
534,919,102,499,1085,1021,64,499
535,920,107,493,1091,1027,64,493
536,931,110,479,1105,1041,64,479
537,904,117,499,1085,1021,64,499
538,918,90,512,1072,1008,64,512
539,925,77,518,1066,1002,64,518
540,933,72,515,1069,1005,64,515
541,922,78,520,1064,1000,64,520
542,932,67,521,1063,999,64,521
543,933,68,519,1065,1001,64,519
544,920,75,525,1059,995,64,525
545,924,66,530,1054,990,64,530
546,933,60,527,1057,993,64,527
547,938,54,528,1056,992,64,528
548,947,54,519,1065,1001,64,519
549,946,62,512,1072,1008,64,512
550,946,72,502,1082,1018,64,502
551,931,81,508,1076,1012,64,508
552,940,75,505,1079,1015,64,505
553,937,77,506,1078,1014,64,506
554,928,84,508,1076,1012,64,508
555,936,81,503,1081,1017,64,503
556,945,73,502,1082,1018,64,502
557,926,85,509,1075,1011,64,509
558,930,90,500,1084,1020,64,500
559,939,79,502,1082,1018,64,502
560,946,70,504,1080,1016,64,504
561,948,78,494,1090,1026,64,494
562,922,92,506,1078,1014,64,506
563,914,94,512,1072,1008,64,512
564,934,80,506,1078,1014,64,506
565,934,83,503,1081,1017,64,503
566,934,86,500,1084,1020,64,500
567,923,98,499,1085,1021,64,499
568,933,93,494,1090,1026,64,494
569,923,95,502,1082,1018,64,502
570,921,85,514,1070,1006,64,514
571,920,76,524,1060,996,64,524
572,913,72,535,1049,985,64,535
573,925,54,541,1043,979,64,541
574,927,52,541,1043,979,64,541
575,907,64,549,1035,971,64,549
576,915,56,549,1035,971,64,549
577,936,56,528,1056,992,64,528
578,937,66,517,1067,1003,64,517
579,941,65,514,1070,1006,64,514
580,932,72,516,1068,1004,64,516
581,926,78,516,1068,1004,64,516
582,920,68,532,1052,988,64,532
583,933,66,521,1063,999,64,521
584,927,72,521,1063,999,64,521
585,931,75,514,1070,1006,64,514
586,931,81,508,1076,1012,64,508
587,936,85,499,1085,1021,64,499
588,933,83,504,1080,1016,64,504
589,930,88,502,1082,1018,64,502
590,922,82,516,1068,1004,64,516
591,929,79,512,1072,1008,64,512
592,938,78,504,1080,1016,64,504
593,918,87,515,1069,1005,64,515
594,910,91,519,1065,1001,64,519
595,916,88,516,1068,1004,64,516
596,933,80,507,1077,1013,64,507
597,927,86,507,1077,1013,64,507
598,933,77,510,1074,1010,64,510
599,926,87,507,1077,1013,64,507
600,923,85,512,1072,1008,64,512
601,928,81,511,1073,1009,64,511
602,926,85,509,1075,1011,64,509
603,923,81,516,1068,1004,64,516
604,920,78,522,1062,998,64,522
605,937,74,509,1075,1011,64,509
606,931,78,511,1073,1009,64,511
607,932,83,505,1079,1015,64,505
608,942,81,497,1087,1023,64,497
609,944,82,494,1090,1026,64,494
610,942,83,495,1089,1025,64,495
611,940,92,488,1096,1032,64,488
612,940,95,485,1099,1035,64,485
613,925,100,495,1089,1025,64,495
614,928,91,501,1083,1019,64,501
615,921,90,509,1075,1011,64,509
616,921,75,524,1060,996,64,524
617,927,63,530,1054,990,64,530
618,929,71,520,1064,1000,64,520
619,920,73,527,1057,993,64,527
620,932,67,521,1063,999,64,521
621,934,71,515,1069,1005,64,515
622,935,79,506,1078,1014,64,506
623,936,85,499,1085,1021,64,499
624,942,80,498,1086,1022,64,498
625,940,90,490,1094,1030,64,490
626,926,94,500,1084,1020,64,500
627,928,86,506,1078,1014,64,506
628,924,90,506,1078,1014,64,506
629,930,88,502,1082,1018,64,502
630,912,96,512,1072,1008,64,512
631,914,85,521,1063,999,64,521
632,919,83,518,1066,1002,64,518
633,923,77,520,1064,1000,64,520
634,922,80,518,1066,1002,64,518
635,921,76,523,1061,997,64,523
636,931,59,530,1054,990,64,530
637,945,58,517,1067,1003,64,517
638,954,55,511,1073,1009,64,511
639,950,66,504,1080,1016,64,504
640,948,77,495,1089,1025,64,495
641,936,83,501,1083,1019,64,501
642,932,87,501,1083,1019,64,501
643,915,97,508,1076,1012,64,508
644,923,83,514,1070,1006,64,514
645,929,81,510,1074,1010,64,510
646,930,81,509,1075,1011,64,509
647,921,75,524,1060,996,64,524
648,939,58,523,1061,997,64,523
649,937,66,517,1067,1003,64,517
650,922,78,520,1064,1000,64,520
651,918,79,523,1061,997,64,523
652,907,77,536,1048,984,64,536
653,913,65,542,1042,978,64,542
654,929,57,534,1050,986,64,534
655,933,61,526,1058,994,64,526
656,934,77,509,1075,1011,64,509
657,923,86,511,1073,1009,64,511
658,932,81,507,1077,1013,64,507
659,918,90,512,1072,1008,64,512
660,942,74,504,1080,1016,64,504
661,936,82,502,1082,1018,64,502
662,923,76,521,1063,999,64,521
663,923,72,525,1059,995,64,525
664,923,83,514,1070,1006,64,514
665,922,89,509,1075,1011,64,509
666,925,84,511,1073,1009,64,511
667,942,77,501,1083,1019,64,501
668,938,78,504,1080,1016,64,504
669,942,71,507,1077,1013,64,507
670,950,67,503,1081,1017,64,503
671,941,76,503,1081,1017,64,503
672,929,85,506,1078,1014,64,506
673,930,83,507,1077,1013,64,507
674,932,77,511,1073,1009,64,511
675,948,71,501,1083,1019,64,501
676,941,83,496,1088,1024,64,496
677,951,83,486,1098,1034,64,486
678,927,102,491,1093,1029,64,491
679,918,95,507,1077,1013,64,507
680,928,80,512,1072,1008,64,512
681,932,78,510,1074,1010,64,510
682,934,81,505,1079,1015,64,505
683,932,88,500,1084,1020,64,500
684,936,85,499,1085,1021,64,499
685,920,91,509,1075,1011,64,509
686,919,77,524,1060,996,64,524
687,923,73,524,1060,996,64,524
688,916,76,528,1056,992,64,528
689,922,66,532,1052,988,64,532
690,940,62,518,1066,1002,64,518
691,927,67,526,1058,994,64,526
692,911,66,543,1041,977,64,543
693,932,56,532,1052,988,64,532
694,920,68,532,1052,988,64,532
695,935,74,511,1073,1009,64,511
696,924,82,514,1070,1006,64,514
697,938,86,496,1088,1024,64,496
698,936,86,498,1086,1022,64,498
699,935,92,493,1091,1027,64,493
700,940,88,492,1092,1028,64,492
701,938,93,489,1095,1031,64,489
702,919,100,501,1083,1019,64,501
703,916,93,511,1073,1009,64,511
704,925,87,508,1076,1012,64,508
705,922,94,504,1080,1016,64,504
706,929,82,509,1075,1011,64,509
707,929,74,517,1067,1003,64,517
708,920,74,526,1058,994,64,526
709,934,62,524,1060,996,64,524
710,948,60,512,1072,1008,64,512
711,957,61,502,1082,1018,64,502
712,932,87,501,1083,1019,64,501
713,949,84,487,1097,1033,64,487
714,934,102,484,1100,1036,64,484
715,916,113,491,1093,1029,64,491
716,919,101,500,1084,1020,64,500
717,922,89,509,1075,1011,64,509
718,929,86,505,1079,1015,64,505
719,918,83,519,1065,1001,64,519
720,926,78,516,1068,1004,64,516
721,928,87,505,1079,1015,64,505
722,928,81,511,1073,1009,64,511
723,939,75,506,1078,1014,64,506
724,945,77,498,1086,1022,64,498
725,943,83,494,1090,1026,64,494
726,939,91,490,1094,1030,64,490
727,925,91,504,1080,1016,64,504
728,912,97,511,1073,1009,64,511
729,915,82,523,1061,997,64,523
730,930,70,520,1064,1000,64,520
731,939,60,521,1063,999,64,521
732,941,68,511,1073,1009,64,511
733,938,79,503,1081,1017,64,503
734,923,89,508,1076,1012,64,508
735,910,88,522,1062,998,64,522
736,919,72,529,1055,991,64,529
737,925,75,520,1064,1000,64,520
738,923,83,514,1070,1006,64,514
739,930,81,509,1075,1011,64,509
740,940,87,493,1091,1027,64,493
741,932,93,495,1089,1025,64,495
742,935,92,493,1091,1027,64,493
743,929,95,496,1088,1024,64,496
744,913,93,514,1070,1006,64,514
745,929,83,508,1076,1012,64,508
746,929,81,510,1074,1010,64,510
747,922,80,518,1066,1002,64,518
748,924,83,513,1071,1007,64,513
749,925,83,512,1072,1008,64,512
750,927,78,515,1069,1005,64,515
751,927,82,511,1073,1009,64,511
752,916,83,521,1063,999,64,521
753,927,70,523,1061,997,64,523
754,921,72,527,1057,993,64,527
755,935,67,518,1066,1002,64,518
756,934,71,515,1069,1005,64,515
757,922,79,519,1065,1001,64,519
758,932,79,509,1075,1011,64,509
759,929,88,503,1081,1017,64,503
760,943,83,494,1090,1026,64,494
761,940,101,479,1105,1041,64,479
762,943,96,481,1103,1039,64,481
763,931,103,486,1098,1034,64,486
764,916,114,490,1094,1030,64,490
765,915,104,501,1083,1019,64,501
766,920,90,510,1074,1010,64,510
767,922,74,524,1060,996,64,524
768,925,67,528,1056,992,64,528
769,939,65,516,1068,1004,64,516
770,944,70,506,1078,1014,64,506
771,932,75,513,1071,1007,64,513
772,935,80,505,1079,1015,64,505
773,926,80,514,1070,1006,64,514
774,923,81,516,1068,1004,64,516
775,922,76,522,1062,998,64,522
776,926,74,520,1064,1000,64,520
777,938,70,512,1072,1008,64,512
778,918,89,513,1071,1007,64,513
779,926,80,514,1070,1006,64,514
780,942,77,501,1083,1019,64,501
781,938,84,498,1086,1022,64,498
782,946,85,489,1095,1031,64,489
783,944,94,482,1102,1038,64,482
784,936,99,485,1099,1035,64,485
785,932,101,487,1097,1033,64,487
786,931,97,492,1092,1028,64,492
787,916,94,510,1074,1010,64,510
788,922,78,520,1064,1000,64,520
789,930,75,515,1069,1005,64,515
790,942,68,510,1074,1010,64,510
791,943,75,502,1082,1018,64,502
792,928,87,505,1079,1015,64,505
793,933,84,503,1081,1017,64,503
794,919,89,512,1072,1008,64,512
795,923,85,512,1072,1008,64,512
796,924,84,512,1072,1008,64,512
797,930,89,501,1083,1019,64,501
798,944,83,493,1091,1027,64,493
799,944,82,494,1090,1026,64,494
800,943,81,496,1088,1024,64,496
801,951,75,494,1090,1026,64,494
802,952,80,488,1096,1032,64,488
803,927,102,491,1093,1029,64,491
804,921,105,494,1090,1026,64,494
805,922,93,505,1079,1015,64,505
806,933,77,510,1074,1010,64,510
807,933,77,510,1074,1010,64,510
808,931,71,518,1066,1002,64,518
809,932,67,521,1063,999,64,521
810,930,67,523,1061,997,64,523
811,928,66,526,1058,994,64,526
812,948,64,508,1076,1012,64,508
813,940,75,505,1079,1015,64,505
814,923,92,505,1079,1015,64,505
815,925,88,507,1077,1013,64,507
816,924,82,514,1070,1006,64,514
817,930,80,510,1074,1010,64,510
818,926,78,516,1068,1004,64,516
819,934,70,516,1068,1004,64,516
820,927,68,525,1059,995,64,525
821,929,66,525,1059,995,64,525
822,934,71,515,1069,1005,64,515
823,939,63,518,1066,1002,64,518
824,939,66,515,1069,1005,64,515
825,926,75,519,1065,1001,64,519
826,933,71,516,1068,1004,64,516
827,932,70,518,1066,1002,64,518
828,929,74,517,1067,1003,64,517
829,948,60,512,1072,1008,64,512
830,943,60,517,1067,1003,64,517
831,928,75,517,1067,1003,64,517
832,946,68,506,1078,1014,64,506
833,947,78,495,1089,1025,64,495
834,946,82,492,1092,1028,64,492
835,953,87,480,1104,1040,64,480
836,921,113,486,1098,1034,64,486
837,921,107,492,1092,1028,64,492
838,917,94,509,1075,1011,64,509
839,921,86,513,1071,1007,64,513
840,922,83,515,1069,1005,64,515
841,927,74,519,1065,1001,64,519
842,935,74,511,1073,1009,64,511
843,927,75,518,1066,1002,64,518
844,922,77,521,1063,999,64,521
845,933,85,502,1082,1018,64,502
846,924,89,507,1077,1013,64,507
847,941,81,498,1086,1022,64,498
848,920,88,512,1072,1008,64,512
849,934,81,505,1079,1015,64,505
850,923,93,504,1080,1016,64,504
851,910,98,512,1072,1008,64,512
852,911,83,526,1058,994,64,526
853,919,73,528,1056,992,64,528
854,935,63,522,1062,998,64,522
855,929,69,522,1062,998,64,522
856,935,63,522,1062,998,64,522
857,928,78,514,1070,1006,64,514
858,946,79,495,1089,1025,64,495
859,918,100,502,1082,1018,64,502
860,945,86,489,1095,1031,64,489
861,930,94,496,1088,1024,64,496
862,936,86,498,1086,1022,64,498
863,930,87,503,1081,1017,64,503
864,931,82,507,1077,1013,64,507
865,945,77,498,1086,1022,64,498
866,934,82,504,1080,1016,64,504
867,923,92,505,1079,1015,64,505
868,911,93,516,1068,1004,64,516
869,924,90,506,1078,1014,64,506
870,925,93,502,1082,1018,64,502
871,940,94,486,1098,1034,64,486
872,923,97,500,1084,1020,64,500
873,933,92,495,1089,1025,64,495
874,935,99,486,1098,1034,64,486
875,924,101,495,1089,1025,64,495
876,924,96,500,1084,1020,64,500
877,918,92,510,1074,1010,64,510
878,917,88,515,1069,1005,64,515
879,912,83,525,1059,995,64,525
880,929,71,520,1064,1000,64,520
881,933,71,516,1068,1004,64,516
882,912,78,530,1054,990,64,530
883,922,72,526,1058,994,64,526
884,937,72,511,1073,1009,64,511
885,933,79,508,1076,1012,64,508
886,919,84,517,1067,1003,64,517
887,920,84,516,1068,1004,64,516
888,930,70,520,1064,1000,64,520
889,923,80,517,1067,1003,64,517
890,920,76,524,1060,996,64,524
891,917,77,526,1058,994,64,526
892,922,73,525,1059,995,64,525
893,936,69,515,1069,1005,64,515
894,936,75,509,1075,1011,64,509
895,936,72,512,1072,1008,64,512
896,936,64,520,1064,1000,64,520
897,924,69,527,1057,993,64,527
898,931,57,532,1052,988,64,532
899,924,60,536,1048,984,64,536
900,944,61,515,1069,1005,64,515
901,949,72,499,1085,1021,64,499
902,949,78,493,1091,1027,64,493
903,955,79,486,1098,1034,64,486
904,934,97,489,1095,1031,64,489
905,929,95,496,1088,1024,64,496
906,935,99,486,1098,1034,64,486
907,914,107,499,1085,1021,64,499
908,913,103,504,1080,1016,64,504
909,927,98,495,1089,1025,64,495
910,933,102,485,1099,1035,64,485
911,924,106,490,1094,1030,64,490
912,923,97,500,1084,1020,64,500
913,927,90,503,1081,1017,64,503
914,937,87,496,1088,1024,64,496
915,929,87,504,1080,1016,64,504
916,930,89,501,1083,1019,64,501
917,928,90,502,1082,1018,64,502
918,911,93,516,1068,1004,64,516
919,921,78,521,1063,999,64,521
920,921,69,530,1054,990,64,530
921,921,74,525,1059,995,64,525
922,924,78,518,1066,1002,64,518
923,924,71,525,1059,995,64,525
924,930,68,522,1062,998,64,522
925,937,67,516,1068,1004,64,516
926,924,81,515,1069,1005,64,515
927,924,80,516,1068,1004,64,516
928,935,71,514,1070,1006,64,514
929,946,77,497,1087,1023,64,497
930,939,88,493,1091,1027,64,493
931,938,90,492,1092,1028,64,492
932,913,106,501,1083,1019,64,501
933,927,96,497,1087,1023,64,497
934,912,98,510,1074,1010,64,510
935,924,88,508,1076,1012,64,508
936,910,89,521,1063,999,64,521
937,916,73,531,1053,989,64,531
938,927,65,528,1056,992,64,528
939,928,68,524,1060,996,64,524
940,952,54,514,1070,1006,64,514
941,934,77,509,1075,1011,64,509
942,930,76,514,1070,1006,64,514
943,942,62,516,1068,1004,64,516
944,935,62,523,1061,997,64,523
945,932,62,526,1058,994,64,526
946,937,67,516,1068,1004,64,516
947,932,83,505,1079,1015,64,505
948,917,78,525,1059,995,64,525
949,913,74,533,1051,987,64,533
950,908,63,549,1035,971,64,549
951,923,55,542,1042,978,64,542
952,938,54,528,1056,992,64,528
953,944,68,508,1076,1012,64,508
954,941,77,502,1082,1018,64,502
955,938,88,494,1090,1026,64,494
956,934,97,489,1095,1031,64,489
957,925,105,490,1094,1030,64,490
958,944,93,483,1101,1037,64,483
959,946,95,479,1105,1041,64,479
960,944,105,471,1113,1049,64,471
961,918,116,486,1098,1034,64,486
962,928,96,496,1088,1024,64,496
963,930,86,504,1080,1016,64,504
964,936,92,492,1092,1028,64,492
965,925,100,495,1089,1025,64,495
966,931,96,493,1091,1027,64,493
967,927,95,498,1086,1022,64,498
968,921,94,505,1079,1015,64,505
969,932,90,498,1086,1022,64,498
970,920,85,515,1069,1005,64,515
971,930,80,510,1074,1010,64,510
972,915,79,526,1058,994,64,526
973,909,74,537,1047,983,64,537
974,909,58,553,1031,967,64,553
975,922,48,550,1034,970,64,550
976,940,41,539,1045,981,64,539
977,953,42,525,1059,995,64,525
978,944,49,527,1057,993,64,527
979,937,51,532,1052,988,64,532
980,926,56,538,1046,982,64,538
981,934,58,528,1056,992,64,528
982,934,64,522,1062,998,64,522
983,940,63,517,1067,1003,64,517
984,941,69,510,1074,1010,64,510
985,941,69,510,1074,1010,64,510
986,948,70,502,1082,1018,64,502
987,944,77,499,1085,1021,64,499
988,943,79,498,1086,1022,64,498
989,939,82,499,1085,1021,64,499
990,954,89,477,1107,1043,64,477
991,923,109,488,1096,1032,64,488
992,922,109,489,1095,1031,64,489
993,920,98,502,1082,1018,64,502
994,936,86,498,1086,1022,64,498
995,948,86,486,1098,1034,64,486
996,926,97,497,1087,1023,64,497
997,924,97,499,1085,1021,64,499
998,926,85,509,1075,1011,64,509
999,923,78,519,1065,1001,64,519
1000,917,82,521,1063,999,64,521
